111111111111
1000P00YC001
1E0010000001
100C010Y0001
111111111111
