1111111111111111111
100Y0000C0000001111
1001011111000001111
10010000C0000001111
1001000Y00000001111
10001111101100000C1
1P011E00000C0000001
1000Y0000Y000000001
10011111111000000C1
100Y000YC0000000111
1001C000000Y0001111
1111111111111111111
